45x24
#############################################
#         #                                 #
#         #                                 #
#         #                                 #
#         #                                 #
#         #                                 #
#         #                                 #
#         #                                 #
#                    #                      #
#                    #                      #
#                    #                      #
#                    #                      #
#                    #                      #
#                    #                      #
#                    #                      #
#                                           #
#                                           #
#                                           #
#                                           #
#                                           #
#                                           #
#                                           #
#                                           #
#############################################
